WWWWWWWWWWWWWWCWWWWW
W P................W
W..WWWWWWWWWWWW..W.W
W..W...........WEW.W
WK.W.WWWWWWWW..W.W.W
W..C.W..E.....W.GW.W
W....W.WWWWWWWW..W.W
W.WWWW...........W.W
W..................W
WWWWWWWWWWWWWWWWWWWW