WWWWWWWWWWWWWWWWWWWW
W P................W
W..WWWWWWWWWWWW..W.W
W..W...........WEW.W
WE.W.WWWWWWWW..W.W.W
W..W.W..E.....W.GW.W
W....W.WWWWWWWW..W.W
W.WWWW...........W.W
W..................W
WWWWWWWWWWWWWWWWWWWW