WWWWWWWWWWWWWWWWWWWW
W..............E...W
W..P...............W
W.......WWWW.......W
W.......W..W.......W
W.......W..W.......W
W..........W.......W
WK.WWWW...E........W
W................G.W
WWWWWWWWWWWWWWWWWWWW