WWWWWWWWWWWWWWWWWWWW
W..................W
W..P...............W
W.......WWWW.......W
W.......W..W.......W
W.......W..W.......W
W..........W.......W
W..WWWW..........E.W
W..................W
WWWWWWWWWWWWWWWWWWWW