WWWWWWWWWWWWCWWWWWWW
W..............E...W
W.P................W
W.......WWWW.......W
W.......W..W.......W
W.......W..W.......W
W..........W.......W
WK.WWCW...E........W
W................G.W
WWWWWWWWWWWWWWWWWWWW